XXXXXXOOOXXXXXX
XOOOOOOEOOOOOOX
XOOFFFOOOOFFFOX
XOOOOOOOOOOOOOX
XOOOFOOOOOFOOOX
XOOOFOOOOOFOOOX
XOOOFOOFOOFOFOX
XOOOOOOFFOFOOXX
XOOOOOOFFOFOOXX
XOOOOOOFFOFOOXX
XOOOOOOFFOFOOXX
XOOOOOOFFOFOOXX
XOOOOOOFFOFOOXX
XOOOOOOFFOFOOXX
XXXXXXOOOXXXXXX