XXXXXXOOOXXXXXX
XOOOOOOEOOOOOOX
XOOFFFOOOOFFFOX
XOOOOOOOOOOOOOX
XOOOFOOOOOFOOOX
XOOOFOOOOOFOOOX
XOEOFOOFOOFOFOX
XOOOOOOFFOFOOXX
XOOOOOOFFOFOOXX
XOOOOOOFFOFOOXX
XOOOOOOFFOFOOXX
XOOOOOOFFOFOOXX
XOOOOOOFFOFOOXX
XOOOOOOFFOFOEXX
XXXXXXOOOXXXXXX