XXXXXXOOOXXXXXX
XOOOOOOOOOOOOOX
XOOFFFOOOOFFFOX
XOOOOOOOOOOOOOX
XOOOFOOOOOFOOOX
XOOOFOOOOOFOOOX
OOOOFOOFOOFOFOX
OOOOOOOFFOXOOXX
OOOOOOOFFOXOOXX
XOOOOOOFFOXOOXX
XOOOOOOFFOXOOXX
XOOOOOOFFOXOOXX
XOOOOOOFFOXOOXX
XOOOOOOFFOXOOXX
XXXXXXOOOXXXXXX