XXXXXXOOOXXXXXX
XOOOOOEOOOOOOOX
XOOFFFOOOOFFFOX
XOOFOOOFOOOOOOX
XOOOFOOFOOFOOOX
XOOOFOOOOOFOOOX
XOOOFOOFOOFOOOO
XOOOOFOFFOFOOOO
XOOFOOOFFOFOOOO
XOOFOOOFFOFOOXX
XOOFFFOFFOFOOXX
XOEFOOOFFOFFXXX
XOOFFFOFFOFEOXX
XOOFOOOOOOFOOXX
XXXXXXOOOXXXXXX