XXXXXXXXXXXXXXXXX
XOOOOOOOOOOOOOOOX
XOFFOFFFOOOOFFFOX
XOFOOOOOOOOOOOOOO
XOOOFOOOOOFOOXOOO
XOOOFOOOOOFOOXOOO
XOOOFOOFOOFOFFOOX
XOOOOOOFFOXOOXOOX
XXXXXXXOOOXXXXXXX