XXXXXXXOOOXXXXXXX
XOOOOOOOOOOOOFOOX
XOOOOFFFOOOOOXOOX
OOOOFFOOFFOOOFOOX
OOXOOOOOOOOOOOOOX
OOFOOOOOOFOOOOOOX
XOFOOFOOOXOOOOOOX
XOXOOFOOOXOOOOOOX
XXXXXXXXXXXXXXXXX