XXXXXXOOOXXXXXX
XOOOOOOOOOOOOOX
XOOFFFOOOOFFFOX
XOOOOOOOOOOOOOX
XOOOFOOOOOFOOOX
XOOOFOOOOOFOOOX
XOOOFOOFOOFOFOX
XOOOOOOFFOXOOXX
XOOOOOOFFOXOOXX
XOOOOOOFFOXOOXX
XOOOOOOFFOXOOXX
XOOOOOOFFOXOOXX
XOOOOOOFFOXOOXX
XOOOOOOFFOXOOXX
XXXXXXOOOXXXXXX