XXXXXXXXXXXXXXXXX
XOOOOOOOOOOOOOOOX
XOFFOFFFOOOOOOOOX
XOFOOOOOOOOOOOOOX
XOOOFOOOOOOOOOOOX
XOOOFOOOOOOOOOOOX
XOOOFOOOOOOOOOOOX
XOOOOOOOOOOOOOOOX
XXXXXXXXXXXXXXXXX