XXXXXXXOOOXXXXXXX
XOOOOOOOOOOOOOOOX
XOFFOFFFOOOOFFFOX
XOFOOOOOOOOOOOOOO
XOOOFOOOOOFOOXOOO
XOOOFOOOOOFOOXOOO
XOOOFOOFOOFOFFOOX
XOOOOOOFFOXOOXOOX
XXXXXXXXXXXXXXXXX