XXXXXXXXXXXXXXX
XOOOOOOOOOOOOOX
XOOFFFOOOOFFFOX
XOOOOOOOOOOOOOX
XOOOFOOOOOFOOOX
XOOOFOOOOOFOOOX
XOOOFOOFOOFOFOX
XOOOOOOFFOFOOXX
XOOOFOOFFOFOOXX
XOOOFOOFFOFOOXX
XOOOFOOFFOFOOXX
XOOOFOOFFOFOOXX
XOOOFOOFFOFOOXX
XOOOOOOFFOFOOXX
XXXXXXXXXXXXXXX