XXXXXXOOOXXXXXX
XOOOOOOOOOOOOOX
XOOFFFOOOOFFFOX
XOOFOOOFOOOOOOX
XOOOFOOFOOFOOOX
XOOOFOOOOOFOOOX
XOOOFOOFOOFOOOO
XOOOOFOFFOFOOOO
XOOFOOOFFOFOOOO
XOOFOOOFFOFOOXX
XOOFFFOFFOFOOXX
XOOFOOOFFOFFXXX
XOOFFFOFFOFOOXX
XOOFOOOOOOFOOXX
XXXXXXOOOXXXXXX