XXXXXXOOOXXXXXX
XOOOOOOEOOOOOOX
XOOFFFOOOOFFFOX
XOOOFOOFFOOOOOX
XOOOFOOOOOFOOOX
XOOOFFOOOOFOOOX
OOOOFOOFOOFOFOX
OOOOOOOFFOFOOOX
OOOOFOOFFOFOOOX
XOOFFFOFFOFOOOX
XOOOOOOFFOFOOXX
XOOFFFOFFOFOOXX
XOOFOFOFFOFOOXX
XOOFOOOFFOFOOXX
XXXXXXOOOXXXXXX