XXXXXXXXXXXXXXXXX
XOOOOOOOOOOOOOOOX
XOFFOFFFOOOOOOOOX
XOFOOOOOOOOOOOOOX
XOOOFOOOOOOOOOOOO
XOOOFOOOOOOOOOOOO
XOOOFOOOOOOOOOOOX
XOOOOOOOOOOOOOOOX
XXXXXXXXXXXXXXXXX